The Guanabara Aniversary starts in hours, but your wife hid your car's key, because you are addicted to Guanabara sales. Now you are in the porch of your house thinking about what to do. Maybe first you want to enter in the house.

The need for Guanabara
An Interactive Fiction by Grupo Random
Release 1 / Serial number 210129 / Inform 7 build 6M62 (I6/v6.33 lib 6/12N) SD

Porch
You can see Main door, Wooden chair and Doormat here.

>examine box
In Old box are candle and string.

* * *

The Guanabara Aniversary starts in hours, but your wife hid your car's key, because you are addicted to Guanabara sales. Now you are in the porch of your house thinking about what to do. Maybe first you want to enter in the house.

The need for Guanabara
An Interactive Fiction by Grupo Random
Release 1 / Serial number 210129 / Inform 7 build 6M62 (I6/v6.33 lib 6/12N) SD

Porch
You can see Main door, Wooden chair and Doormat here.

>open Main door
The door is closed
It seems to be locked.

>get Main key
A chill runs up your spine
Taken.

>open Main door
It seems to be locked.

>use Main eky
That's not a verb I recognise.

>use Main key
That's not a verb I recognise.

>Main key
That's not a verb I recognise.

>use Main key
That's not a verb I recognise.

>open Main door with Main key
You unlock Main door.

>open Main door
You open Main door.

>enter
You get onto Wooden chair.

>enter Main door
You can't sit in a occupied chair

>get up
You get off Wooden chair.

Porch
You can see Main door, Wooden chair, Old box (in which are candle and string) and bucket (empty) here.

>enter Main door
Hall
You can see Main door here.

The inside smells as bad news...

>see
That's not a verb I recognise.

>look
Hall
You can see Main door here.

>walk
You'll have to say which compass direction to go in.

>walk front
You can't see any such thing.

>walk north
Living Room

>look
Living Room

>walk north
Dining Room

>look
Dining Room

* * *

>open Main door
The door is closed
It seems to be locked.

>enter Main door
The door is closed and you don't remember where is your key.

(first opening Main door)
It seems to be locked.

* * *

The Guanabara Aniversary starts in hours, but your wife hid your car's key, because you are addicted to Guanabara sales. Now you are in the porch of your house thinking about what to do. Maybe first you want to enter in the house.

The need for Guanabara
An Interactive Fiction by Grupo Random
Release 1 / Serial number 210129 / Inform 7 build 6M62 (I6/v6.33 lib 6/12N) SD

Porch
You can see Main door, Wooden chair and Doormat here.

>open Doormat
It isn't something you can open.

>get Main key in Doormat
I only understood you as far as wanting to get Main key.

>look doormat
In Doormat is Main key.

>get Main Key
This is the extra key for your hosue
Taken.

* * *

The Guanabara Aniversary starts in hours, but your wife hid your car's key, because you are addicted to Guanabara sales. Now you are in the porch of your house thinking about what to do. Maybe first you want to enter in the house.

The need for Guanabara
An Interactive Fiction by Grupo Random
Release 1 / Serial number 210129 / Inform 7 build 6M62 (I6/v6.33 lib 6/12N) SD

Porch
You can see Main door, Wooden chair and Doormat here.

>sit on chair
You feel confortable

* * *

The Guanabara Aniversary starts in hours, but your wife hid your car's key, because you are addicted to Guanabara sales. Now you are in the porch of your house thinking about what to do. Maybe first you want to enter in the house.

The need for Guanabara
An Interactive Fiction by Grupo Random
Release 1 / Serial number 210129 / Inform 7 build 6M62 (I6/v6.33 lib 6/12N) SD

Porch
You can see Main door, Wooden chair and Doormat here.

>Open main door
The door is closed and you don't remeber where your keys are.

It seems to be locked.

* * *

The Guanabara Aniversary starts in hours, but your wife hid your car's key, because you are addicted to Guanabara sales. Now you are in the porch of your house thinking about what to do. Maybe first you want to enter in the house.

The need for Guanabara
An Interactive Fiction by Grupo Random
Release 1 / Serial number 210129 / Inform 7 build 6M62 (I6/v6.33 lib 6/12N) SD

Porch
You can see Main door, Wooden chair and Doormat here.

>open main door
The door is closed and you don't remeber where your keys are.

* * *

The Guanabara Aniversary starts in hours, but your wife hid your car's key, because you are addicted to Guanabara sales. Now you are in the porch of your house thinking about what to do. Maybe first you want to enter in the house.

The need for Guanabara
An Interactive Fiction by Grupo Random
Release 1 / Serial number 210129 / Inform 7 build 6M62 (I6/v6.33 lib 6/12N) SD

Porch
You can see Main door, Wooden chair and Doormat here.

>look doormat
A Doormat is used to clean the shoe's sole. Sometimes people hide keys under them.

>looking under
That's not a verb I recognise.

>look under doormat
You see the Doormat and remembers that maybe your family left an extra key. You look under the Doormat and see a key thant now you can take it

>take Main key
This is the extra key for your house, now you can enter
Taken.

* * *

>look doormat
A Doormat is used to clean the shoe's sole. Sometimes people hide keys under them.

>look under doormat
You see the Doormat and remembers that maybe your family left an extra key. You look under the Doormat and see an extra key for your house and now you can take it

>take key
This is the extra key for your house, now you can enter
Taken.

* * *

>look doormat
A Doormat is used to clean the shoe's sole. Sometimes people hide keys under them.

>unlock door
What do you want to unlock Main door with?

>inventory
You are carrying nothing.

>look under doormat
You remembers that maybe your family left an extra key under the Doormat. You look under and see an extra key for your house and you take it

>unlock door
(with House key)
You unlock Main door.

>open door
You open Main door.

>go north
Hall
Sophia, your daughter is standing in the middle of the hall.

You can also see Main door here.

>go north
Living Room
The old bookcase is there too.

A broom is leaning on a wall.

>go east
Home Office

>go west
Living Room
The old bookcase is there too.

A broom is leaning on a wall.

>go north
Dining Room

>go westr
You can't see any such thing.

>go west
Kitchen
You can see Kitchen drawer (closed) here.

>open drawer
You open Kitchen drawer, revealing Monica Gang's Tomato Flavored Noodles.

>look noodles
Some Monica Gang's tomato flavored noodles made by you with love

>take Monica Gang's Tomato Flavored Noodles
Taken.

>inventory
You are carrying:
  Monica Gang's Tomato Flavored Noodles
  House key

* * *

The Guanabara Aniversary starts in hours, but your wife hid your car's key, because you are addicted to Guanabara sales. Now you are in the porch of your house thinking about what to do. Maybe first you want to enter in the house.

The need for Guanabara
An Interactive Fiction by Grupo Random
Release 1 / Serial number 210129 / Inform 7 build 6M62 (I6/v6.33 lib 6/12N) SD

Porch
You can see Main door, Wooden chair and Doormat here.

>look under doormat
You remembers that maybe your family left an extra key under the Doormat. You look under and see an extra key for your house and you take it

>take key
This is the extra key for your house, now you can enter

>open door
It seems to be locked.

>use key
That's not a verb I recognise.

>use House key in Main door
That's not a verb I recognise.

>open Main door with House key
You unlock Main door.

* * *

>open door
It seems to be locked.

>unlock door
(with House key)
You unlock Main door.

>enter
You get onto Wooden chair.

>get out
You get off Wooden chair.

Porch
You can see Main door, Wooden chair and Doormat here.

>enter main door
(first opening Main door)
Use your key

>enter main door
(first opening Main door)
Use your key

>go north
(first opening Main door)
Use your key

* * *

>unlock door
(with House key)
You unlock Main door.

>enter door
(first opening Main door)

Hall
Your daughter is standing in the middle of the hall.

You can also see Main door here.

>kiss your daughter
You can't see any such thing.

>kiss Your daughter
You can't see any such thing.

* * *

>take key
This is the extra key for your house, now you can enter

>unlock door
(with House key)
You unlock Main door.

>go north
(first opening Main door)

Hall
You can see Main door here.

You see your daughter standing in the middle of the Hall

* * *

>get out
You get off Wooden chair.

Porch
You can see Main door, Wooden chair and Doormat here.

>enter main door
(first opening Main door)

Hall
You can see Main door and your daugther here.

>talk
That's not a verb I recognise.

>talk with your daugther
That's not a verb I recognise.

>look your daugther
You can't see any such thing.

>talk to your daughter
That's not a verb I recognise.

>ask your daugther about the sun
You can't see any such thing.

>examine
(House key)
You see nothing special about House key.

>examine Hall
You can't see any such thing.

>talk to your daughter
That's not a verb I recognise.

>talk to
That's not a verb I recognise.

>ask about
You can't see any such thing.

* * *

>open door
You open Main door.

>enter door
Hall
Sophia, your daughter is standing in the middle of the hall.

You can also see Main door here.

>talk to sophia
That's not a verb I recognise.

>ask sophia
(for House key)
(Sophia first taking House key)
Sophia has better things to do.

>ask sophia about zapzap
There is no reply.

* * *

>unlock door
(with House key)
You unlock Main door.

>enter door
(first opening Main door)

Hall
Sophia, your daughter is standing in the middle of the hall.

You can also see Main door here.

>talk to sophia
"Hey Sophia, i need your help! I need to go to Guanabara, in few hours the Guanabara anniversary will start!" you say.  "I know, dad, and i can help you, but it's not gonna be easy.." she says.

* * *

>look under doormat
You remembers that maybe your family left an extra key under the Doormat. You look under and see an extra key for your house and you take it

>get key
This is the extra key for your house, now you can enter

>unlock door
(with House key)
You unlock Main door.

* * *

>open door
You open Main door.

>enter door
Hall
Your daughter is standing in the middle of the hall.

You can also see Main door here.

>look Filha
She is looking in a funny way to you, kind of suspect.

>kiss Filha
Filha might not like that.

* * *

>look under doormat
You remembers that maybe your family left an extra key under the Doormat. You look under and see an extra key for your house and you take it

>inventory
You are carrying:
  House key

>unlock door
(with House key)
You unlock Main door.

* * *

>enter door
Hall
Sophia, your daughter is standing in the middle of the hall.

You can also see Main door here.

>talk to sophia
"Hey Sophia, i need your help! I need to go to Guanabara, in few hours the Guanabara anniversary will start!" you say.  "I know, dad, and i can help you, but it's not gonna be easy.." she replies.

>examine room
You can't see any such thing.

>examine
(House key)
You see nothing special about House key.

>look
Hall
Sophia, your daughter is standing in the middle of the hall.

You can also see Main door here.

>climb stair
You can't see any such thing.

>climb Stairs
Upper Hall

>look
Upper Hall

>look north
You see nothing unexpected in that direction.

>climb stairs
Hall
Sophia, your daughter is standing in the middle of the hall.

You can also see Main door here.

>go north
Living Room
You can see Bookcase here.

>look bookcase
A bookcase with a lot of books, making it quite heavy, being impossible to move.

>look under bookcase
You find nothing of interest.

* * *

>enter door
(first opening Main door)

Hall
Sophia, your daughter is standing in the middle of the hall.

You can also see Main door here.

>go north
Living Room
The old bookcase is there too.

A broom is leaning on a wall.

>examine bookcas
You can't see any such thing.

>look the Bookcase
A bookcase with a lot of books, making it quite heavy, being impossible to move.

>look bookcase
A bookcase with a lot of books, making it quite heavy, being impossible to move.

>look under
(House key)
You find nothing of interest.

>look under bookcase
You see a note and try to get with your hands, but it's too far, you will need something to help you reach.

>look broom
A broom used to clean the room ground. Or to reach things

>take broom
Taken.

>look under bookcase
You use the broom to reach and get the note

>inventory
You are carrying:
  First Note
  Broom
  House key

>read first note
Good job dad, now the next step is:
Make some noodles to me, but before, wash your hands in the lavabo, then make the noodles and bring then to me

>go north
Dining Room

>go west
Kitchen

* * *

>enter door
Hall
Sophia, your daughter is standing in the middle of the hall.

You can also see Main door here.

>talk to sophia
"Hey Sophia, i need your help! I need to go to Guanabara, in few hours the Guanabara anniversary will start!" you say.
  "I know, dad, and i can help you, but it's not gonna be easy." she replies.

>go north
Living Room
A broom is leaning on a wall.

You can also see Bookcase here.

>look bookcase
A bookcase with a lot of books, making it quite heavy, being impossible to move.

>look under bookcase
You see a note and try to get with your hands, but it's too far, you will need something to help you reach.

>take broom
Taken.

>use broom under the bookcase
You can't do this.

* * *

>go north
Living Room
The old bookcase is there too.

A broom is leaning on a wall.

>take broom
Taken.

* * *

>look under bookcase
You use the broom to reach and get the note

>go north
Dining Room

>go west
Kitchen
You can see Kitchen drawer (closed) and Cooker here.

>open drawer
You open Kitchen drawer, revealing Monica Gang's Tomato Flavored Noodles.

>take noodles
Taken.

>cook noodles
You take a pot, fill with water and light on the cooker. With the noodles pack in your hands, you put everything, except the flavor powder, inside the pot then wait for 3 minutes

>inventory
You are carrying:
  Cooked Noodles
  First Note
  Broom
  House key

>cook noodles
You take a pot, fill with water and light on the cooker. With the noodles pack in your hands, you put everything, except the flavor powder, inside the pot then wait for 3 minutes

>go east
Dining Room

>go south
Living Room
The old bookcase is there too.

>go south
Hall
Sophia, your daughter is standing in the middle of the hall.

You can also see Main door here.

>give noodles to sophia
Sophia doesn't seem interested.

>read note
You see some writings in the note: "Good job dad, now the next step is:
Make some noodles to me, but before, wash your hands in the lavabo, then make the noodles and bring then to me"

* * *

>unlock door
(with House key)
You unlock Main door.

>open doork
You can't see any such thing.

>open door
You open Main door.

* * *

>enter door
Hall
Sophia, your daughter is standing in the middle of the hall.

You can also see Main door here.

>go north
Living Room
The old bookcase is there too.

A broom is leaning on a wall.

* * *

>use broom under the bookcase
You can't do this.

>use broom under bookcase
You can't do this.

* * *

>go north
Dining Room

>go west
Kitchen
You can see Kitchen drawer (closed) here.

* * *

>take noodles
Taken.

>cook
What do you want to cook?

>cook noodles
You don't have time to cook anymore.

* * *

>look under bookcase
You use the broom to reach and get the note

>look note
You see some writings in the note:
"Good job dad, now the next step is:
Make some noodles to me, but before, wash your hands in the lavabo, then make the noodles and bring then to me"

>go north
Dining Room

* * *

>cook
What do you want to cook?

>cook noodles
You need to wash your hands before cooking

>go east
Dining Room

* * *

>go south
Living Room
The old bookcase is there too.

>go east
Home Office

* * *

>go west
Living Room
The old bookcase is there too.

>go south
Hall
Sophia, your daughter is standing in the middle of the hall.

You can also see Main door here.

>go east
Lavabo
Your house's lavabo. There is a small cabinet under the sink used to keep toilet paper.

>wash hands
You wash your hands the way you learned to prevent Coronavirus.

>wash hands
You already washed your hands.

>go west
Hall
Sophia, your daughter is standing in the middle of the hall.

You can also see Main door here.

>go north
Living Room
The old bookcase is there too.

>go north
Dining Room

>go west
Kitchen
You can see Kitchen drawer (empty) and Cooker here.

>cook noodles
You take a pot, fill with water and light on the cooker. With the noodles pack in your hands, you put everything, except the flavor powder, inside the pot then wait a little to put the flavor inside, then wait a bit more for the noodles to be ready.

>inventory
You are carrying:
  Cooked Noodles
  First Note
  Broom
  House key

>go east
Dining Room

* * *

>give noodles to sophia
Sophia doesn't seem interested.

>inventory
You are carrying:
  Cooked Noodles
  First Note
  Broom
  House key

>give noodles to sophia
Sophia doesn't seem interested.

>give Cooked Noodles to Sophia
You can't see any such thing.

>give cooked to sophia
You can't see any such thing.

>look cooked noodles
You can't see any such thing.

>look noodles
You see nothing special about Cooked Noodles.

>look Monica Gang's Tomato Flavored Noodles
You see nothing special about Cooked Noodles.

* * *

>enter door
(first opening Main door)

Hall
Sophia, your daughter is standing in the middle of the hall.

You can also see Main door here.

>go east
Lavabo
Your house's lavabo. There is a small cabinet under the sink used to keep toilet paper.

* * *

>wash hands
You wash your hands the way you learned to prevent Coronavirus.

>wash
You wash your hands the way you learned to prevent Coronavirus.

* * *

>wash hands
You already washed your hands.

>wash hands
You already washed your hands.

* * *

>wash hands
You wash your hands the way you learned to prevent Coronavirus.

>go west
Hall
Sophia, your daughter is standing in the middle of the hall.

You can also see Main door here.

>go north
Living Room
The old bookcase is there too.

A broom is leaning on a wall.

* * *

>go north
Dining Room

>go north
You can't go that way.

>go west
Kitchen
You can see Kitchen drawer (closed) and Cooker here.

* * *

>take noodles
Taken.

>cook noodles
You take a pot, fill with water and light on the cooker. With the noodles pack in your hands, you put everything, except the flavor powder, inside the pot then wait a little to put the flavor inside, then wait a bit more for the noodles to be ready.

* * *

>go south
Hall
Sophia, your daughter is standing in the middle of the hall.

You can also see Main door here.

>give noodles to sophia
Thanks, dad.

>inventory
You are carrying:
  First Note
  Broom
  House key

>look sophia inventory
I only understood you as far as wanting to look Sophia.

>climb stairs
Upper Hall

>go west
Small Bedroom
Your youngest son's bedroom.

Your son Bob, basically a baby, is in the room.

You can also see Guest's Bed here.

>look bob
You see nothing special about Bob.

>examine bob
You see nothing special about Bob.

>clear Small Bedroom
You can't see any such thing.

>clear bedroom
You can't see any such thing.

>clean bedroom
You can't see any such thing.

>sweep bedroom
You can't see any such thing.

>sweep
What do you want to sweep?

* * *

>go west
Hall
Sophia, your daughter is standing in the middle of the hall.

You can also see Main door here.

>talk to sophia
"Hey Sophia, i need your help! I need to go to Guanabara, in few hours the Guanabara anniversary will start!" you say.
 "I know, dad, and i can help you, but it's not gonna be easy." she replies.

* * *

>enter door
(first opening Main door)

Hall
Sophia, your daughter is standing in the middle of the hall.

You can also see Main door here.

>talk to sophia
"Hey Sophia, i need your help! I need to go to Guanabara, in few hours the Guanabara anniversary will start!" you say.
 "I know, dad, and i can help you, but it's not gonna be easy." she replies then continues:
"Before anything, i want you to make some tasks to me, the first one you will find in the Living Room"

>go north
Living Room
The old bookcase is there too.

A broom is leaning on a wall.

>look to bookcase
You can't see any such thing.

>look bookcase
A bookcase with a lot of books, making it quite heavy, being impossible to move.

* * *

>look under bookcase
You use the broom to reach and get the note

>read note
You see some writings in the note:
"Good job dad, now the next step is:
Make some noodles to me, but before, wash your hands in the lavabo, then make the noodles and bring then to me"

>go north
Dining Room

* * *

>go west
Kitchen
You can see Kitchen drawer (closed) and Cooker here.

>open drawer
You open Kitchen drawer, revealing Monica Gang's Tomato Flavored Noodles and Bird food.

>take noodles
Taken.

>look bird food
Used to feed Blond Joseph

>cook noodles
You need to wash your hands before cooking

* * *

>go north
Dining Room

>go west
Kitchen
You can see Kitchen drawer (in which is Bird food) and Cooker here.

>cook noodles
You take a pot, fill with water and light on the cooker. With the noodles pack in your hands, you put everything, except the flavor powder, inside the pot then wait a little to put the flavor inside, then wait a bit more for the noodles to be ready.

* * *

>inventory
You are carrying:
  Cooked Noodles
  First Note
  Broom
  House key

>look noodles
The best noodles in the whole world.

>go east
Dining Room

* * *

>go south
Hall
Sophia, your daughter is standing in the middle of the hall.

You can also see Main door here.

>give noodle to sophia
You can't see any such thing.

>give noodles to sophia
Thanks, dad.
Now, to your next task, i will need you to sweep the bedroom's floor and to clean the bathroom's.

>go north
Living Room
The old bookcase is there too.

* * *

>go north
Dining Room

>o west
Sorry, that can't be corrected.

>go west
Kitchen
You can see Kitchen drawer (in which is Bird food) and Cooker here.

>take bird food
Taken.

>go east
Dining Room

* * *

>go south
Hall
Sophia, your daughter is standing in the middle of the hall.

You can also see Main door here.

>talk to sophia
Sophia doesn't reply.

>climb staris
You can't see any such thing.

>climb stairs
Upper Hall

>go west
Small Bedroom
Your youngest son's bedroom.

Blond Joseph is in the room, in a stand, screaming extremely loud.

You can also see Guest's Bed here.

>look joseph
He is a parrot, something looks like it's coming out from his back, maybe an arm.

>talk to joseph
He is screaming: "Where is Any Mary?!?! Where she is???"

>talk to joseph
You can't talk to him anymore, he is too angry with something, you need to calm him down.

>sweep floor
Blond Joseph is still screaming and it's disturbing you, if you dont calm down him, you will not be able to clean the floor

>give food to joseph
He eats and calm down, now you can clean the floor

>talk to joseph
You can't talk to him anymore, he is too angry with something, you need to calm him down.

I beg your pardon?

>sweep floor
Blond Joseph is still screaming and it's disturbing you, if you dont calm down him, you will not be able to clean the floor

* * *

>look under doormat
You remembers that maybe your family left an extra key under the Doormat. You look under and see an extra key for your house and you take it

>unlock door, open door and enter door
You can't use multiple objects with that verb.

>unlock door
(with House key)
You unlock Main door.

* * *

>go north
Living Room
The old bookcase is there too.

A broom is leaning on a wall.

>look under bookcase
You see a note and try to get with your hands, but it's too far, you will need something to help you reach.

* * *

>look under bookcase
You use the broom to reach and get the note

>look under bookcase
There's nothing more there.

>inventory
You are carrying:
  First Note
  Broom
  House key

>read first note
You see nothing special about First Note.

* * *

>look under doormat
You remembers that maybe your family left an extra key under the Doormat. You look under and see an extra key for your house and you take it

>unlock doormat
(with House key)
That doesn't seem to be something you can unlock.

>enter door
(first opening Main door)
It seems to be locked.

>unlock door
(with House key)
You unlock Main door.

>go north
(first opening Main door)

Hall
Sophia, your daughter is standing in the middle of the hall.

You can also see Main door here.

>go east
Lavabo
Your house's lavabo. There is a small cabinet under the sink used to keep toilet paper.

>inspect
That's not a verb I recognise.

>inspect east
That's not a verb I recognise.

>examine
(House key)
You see nothing special about House key.

>examine east
You see nothing unexpected in that direction.

>examine west
You see nothing unexpected in that direction.

>wash hands
You can't see any such thing.

>examine
(House key)
You see nothing special about House key.

>look
Lavabo
Your house's lavabo. There is a small cabinet under the sink used to keep toilet paper.

>look west
You see nothing unexpected in that direction.

>wash key
You wash your hands the way you learned to prevent Coronavirus.

>wash key
You wash your hands the way you learned to prevent Coronavirus.

* * *

The Guanabara Aniversary starts in hours, but your wife hid your car's key, because you are addicted to Guanabara sales. Now you are in the porch of your house thinking about what to do. Maybe first you want to enter in the house.

The need for Guanabara
An Interactive Fiction by Grupo Random
Release 1 / Serial number 210129 / Inform 7 build 6M62 (I6/v6.33 lib 6/12N) SD

Porch
You can see Main door, Wooden chair and Doormat here.

>open door
The door is closed and you don't remeber where your keys are.

>examine doormat
A Doormat used to clean the shoe's sole. Sometimes people hide keys under them.

>look under doormat
You see the Doormat and remembers that maybe your family left an extra key. You look under the Doormat and see an extra key for your house and now you can take it

>take key
This is the extra key for your house, now you can enter

>open door with key
You unlock Main door.

>enter door
(first opening Main door)
Use your key

* * *

The Guanabara Aniversary starts in hours, but your wife hid your car's key, because you are addicted to Guanabara sales. Now you are in the porch of your house thinking about what to do. Maybe first you want to enter in the house.

The need for Guanabara
An Interactive Fiction by Grupo Random
Release 1 / Serial number 210129 / Inform 7 build 6M62 (I6/v6.33 lib 6/12N) SD

Porch
You can see Main door, Wooden chair and Doormat here.

>look under the doormat
You remembers that maybe your family left an extra key under the Doormat. You look under and see an extra key for your house and now you can take it

>take key
This is the extra key for your house, now you can enter

* * *

>enter door
Hall
Your daughter is standing in the middle of the hall.

You can also see Main door here.

>kiss your daughter
You can't see any such thing.

>look your daughter
You can't see any such thing.

* * *

The Guanabara Aniversary starts in hours, but your wife hid your car's key, because you are addicted to Guanabara sales. Now you are in the porch of your house thinking about what to do. Maybe first you want to enter in the house.

The need for Guanabara
An Interactive Fiction by Grupo Random
Release 1 / Serial number 210129 / Inform 7 build 6M62 (I6/v6.33 lib 6/12N) SD

Porch
You can see Main door, Wooden chair and Doormat here.

>examine doormat
A Doormat is used to clean the shoe's sole. Sometimes people hide keys under them.

>look under doormat
You remembers that maybe your family left an extra key under the Doormat. You look under and see an extra key for your house and now you can take it

>take key
This is the extra key for your house, now you can enter

* * *

The Guanabara Aniversary starts in hours, but your wife hid your car's key, because you are addicted to Guanabara sales. Now you are in the porch of your house thinking about what to do. Maybe first you want to enter in the house.

The need for Guanabara
An Interactive Fiction by Grupo Random
Release 1 / Serial number 210129 / Inform 7 build 6M62 (I6/v6.33 lib 6/12N) SD

Porch
You can see Main door, Wooden chair and Doormat here.

>enter chair
You get onto Wooden chair.

>get out
You get off Wooden chair.

Porch
You can see Main door, Wooden chair and Doormat here.

>sit chair
I didn't understand that sentence.

>sit on chair
You feel confortable

>get out
You get off Wooden chair.

Porch
You can see Main door, Wooden chair and Doormat here.

>look under doormat
You remembers that maybe your family left an extra key under the Doormat. You look under and see an extra key for your house and now you can take it

* * *

>enter door
(first opening Main door)

Hall
Sophia, your daughter is standing in the middle of the hall.

You can also see Main door here.

>ask sophia about zap
There is no reply.

>talk to sophia
"Hey Sophia, i need your help! I need to go to Guanabara, in few hours the Guanabara anniversary will start!" you say.  "I know, dad, and i can help you, but it's not gonna be easy.." she replies.